#
#
#
#
#
#
#
#
#
#
org_code	eng_org	chn_org	eng_abbr	comment	comment2
aba	Acinetobacter baumannii	±«Âü²»¶¯¸Ë¾ú	A.baumannii	
ac-	Acinetobacter sp.	²»¶¯¸Ë¾úÊô	Acinetobacter sp.	
aca	Acinetobacter calcoaceticus	´×Ëá¸Æ²»¶¯¸Ë¾ú	A.calcoaceticus	
act	Actinomyces sp.	·ÅÏß¾úÊô		
acv	Aeromonas caviae	ëàÊóÆøµ¥°û¾ú	A.caviae	
ade	Alcaligenes xylosoxidans ss. denitrificans	·´Ïõ»¯ÎŞÉ«¸Ë¾ú	A.xylosoxidans ss. denitrificans	ÎŞÉ«¸Ë¾úÊô
aeh	Aeromonas hydrophila	ÊÈË®Æøµ¥°û¾ú	A.hydrophila	
afa	Alcaligenes faecalis (odorans)	·à²ú¼î¸Ë¾ú	A.faecalis (odorans)	
afl	Aspergillus flavus	»ÆÇúÃ¹¾ú	A.flavus	
afu	Aspergillus fumigatus	ÑÌÇúÃ¹¾ú	A.fumigatus	
aha	Acinetobacter haemolyticus	ÈÜÑª²»¶¯¸Ë¾ú	A.haemolyticus	
ajo	Acinetobacter johnsonii	Ô¼ÊÏ²»¶¯¸Ë¾ú		²»¶¯¸Ë¾ú
aju	Acinetobacter junii	ÇíÊÏ²»¶¯¸Ë¾ú	A.junii	
alc	Alcaligenes sp.	²ú¼î¸Ë¾úÊô	Alcaligenes sp.	
alw	Acinetobacter lwoffii	Âå·Ç²»¶¯¸Ë¾ú	A.lwoffii	
ame	Actinomyces meyeri	ÂóÊÏ·ÅÏß¾ú		
ane	Actinomyces naeslundii	ÄÚÊÏ·ÅÏß¾ú		ÑáÑõ¾ú
ani	Aspergillus niger	ºÚÇúÃ¹¾ú	A.niger	
aoi	Alloiococcus otitidis	¶úÑ×²îÒìÇò¾ú	A.otitidis	
aso	Aeromonas sobria	ÎÂºÍÆøµ¥°û¾ú	A.sobria	Æøµ¥°û¾úÊô
asp	Aspergillus sp.	ÇúÃ¹¾úÊô	Aspergillus sp.	
ate	Aspergillus terreus	ÍÁÇúÃ¹¾ú	A.terreus	
atu	Rhizobium radiobacter	·ÅÉä¸ùÁö¾ú	R.radiobacter	
avi	Aerococcus viridans	Ç³ÂÌÆøÇò¾ú		
avl	Aspergillus versicolor	ÔÓÉ«ÇúÃ¹		
axy	Achromobacter xylosoxidans ss. xylosoxidans	Ä¾ÌÇÑõ»¯²ú¼î¸Ë¾ú	A.xylosoxidans	
bbi	Prevotella bivia	¶şÂ·ÆÕÀ×ÎÖ¶û¾ú		
bbr		Ö§Æø¹ÜÑ×±«ÌØ¾ú		
bca	Moraxella (Branh.) catarrhalis	¿¨ËûÄªÀ­¾ú	M.catarrhalis	
bce	Bacillus cereus	À¯ÑùÑ¿æß¸Ë¾ú		Ñ¿æß¸Ë¾ú
bde	Prevotella denticola	ÆÜÑÀÆÕÀ×ÎÖ¾ú	P.denticola	ÆÕÀ×ÎÖ¾úÊô
bfr	Bacteroides fragilis	´àÈõÄâ¸Ë¾ú		
bgl	Burkholderia gladioli	ÌÆİÅÆÑ²®¿Ë»ô¶ûµÂ¾ú		
bme	Prevotella melaninogenica	²úºÚËØÆÕÀ×ÎÖ¾ú		
bmt	Brucella melitensis	Ñò²¼ÊÏ¸Ë¾ú	B.melitensis	
br-	Brucella sp.	²¼ÊÏ¸Ë¾ú		
bsl	Bacillus subtilis	¿İ²İÑ¿æß¸Ë¾ú	B.subtilis	
bth	Bacteroides thetaiotaomicron	¶àĞÎÄâ¸Ë¾ú		
cac	Delftia acidovorans	Ê³Ëá´ú¶û·òÌØ¾ú	D.acidovorans	
caf	Corynebacterium afermentans	·Ç·¢½Í°ô¸Ë¾ú		
caj	Campylobacter jejuni ss. Jejuni	¿Õ³¦ÍäÇú¾ú		
cal	Candida albicans	°×É«ÄîÖé¾ú	C.albicans	
cba	Clostridium barati	°ÍÊÏËó¾ú		
cbk	Citrobacter braakii	²¼ÊÏÄûÃÊËá¸Ë¾ú	C.braakii	
ccl	Clostridium clostridiiforme	Ëó×´Ëó¾ú		
cco	Campylobacter coli	´ó³¦ÍäÇú¸Ë¾ú	C.coli	
cd2	Corynebacterium urealyticum	½âëå°ô¸Ë¾ú		
cdi	Citrobacter koseri (diversus)	¿ËÊÏÄûÃÊËá¸Ë¾ú	C.koseri (diversus)	
cdu	Candida dubliniensis	¶¼°ØÁÖÄîÖé¾ú		
cfr	Citrobacter freundii	¸¥ÊÏèÛéÚËá¸Ë¾ú	C.freundii	
cgl	Candida glabrata	¹â»¬ÄîÖé¾ú	C.glabrata	
cgm	Corynebacterium glutamicum	¹È°±Ëá°ô¸Ë¾ú		
cgu	Candida guilliermondii	¼ªÀûÃÉÄîÖé¾ú	C.guilliermondii	
ci2	Corynebacterium amycolatum	ÎŞÖ¦¾úËá°ô¸Ë¾ú		°ô¸Ë¾ú
cjk	Corynebacterium jeikeium	½ÜÊÏ°ô¸Ë¾ú	C.jeikeium	
ckr	Candida krusei	¿ËÈáÄîÖé¾ú	C.krusei	
cln	Cryptococcus laurentii	ÂŞÂ×ÒşÇò½ÍÄ¸	C.laurentii	
clp	Candida lipolytica	½âÖ¬¼ÙË¿½ÍÄ¸	C.lipolytica	
clt	Chryseomonas luteola	Ç³»Æ½ğÉ«µ¥°û¾ú		
clu	Candida lusitaniae	ÆÏÌÑÑÀ¼ÙË¿½ÍÄ¸	C.lusitaniae	
cmi	Corynebacterium minutissimum	¼«Ğ¡°ô¸Ë¾ú		
cml	Citrobacter amalonaticus	ÎŞ±û¶şËáÄûÃÊËá¸Ë¾ú	EBC	ÄûÃÊËá¸Ë¾úÊô
cne	Cryptococcus neoformans	ĞÂĞÍÒşÇò¾ú	C.neoformans	
cnp	Candida pelliculosa	½ÇÄ¤¼ÙË¿½ÍÄ¸		ÄîÖé¾ú
cop	Salmonella Copenhagen	¸ç±¾¹ş¸ùÉ³ÃÅÊÏ¾ú		
cor	Corynebacterium sp.	°ô×´¸Ë¾úÊô	Corynebacterium sp.	
cpa	Candida parapsilosis	½üÆ½»¬ÄîÖé¾ú	C.parapsilosis	
cpe	Clostridium perfringens	²úÆø¼ÔÄ¤Ëó¾ú		
cps	Candida kefyr	Èé¾Æ¼ÙË¿½ÍÄ¸	C.kefyr	
cra	Clostridium ramosum	¶àÖ¦Ëó¾ú		
cru	Candida rugosa	ÖåÕÛÄîÖé¾ú	FUNGUS	ÄîÖé¾úÊô
cry		ÒşÇò¾úÊô		
cse	Clostridium septicum	°ÜÑªËó¾ú		
cso	Clostridium sordellii	Ë÷ÊÏËó¾ú		
cst		ÎÆ´ø°ô¸Ë¾ú		
ctr	Candida tropicalis	ÈÈ´øÄîÖé¾ú	C.tropicalis	
cts	Comamonas testosteroni	ØºÍª¼Ùµ¥°û¾ú	C.testosteroni	
ctt	Clostridium tertium	µÚÈıËó¾ú		
cut	Candida utilis	²úëÃ¼ÙË¿½ÍÄ¸¾ú	C.utilis	
cyo	Citrobacter youngae	ÑîÊÏèÛéÚËá¸Ë¾ú	C.youngae	
dxe	"Streptococcus, Group D"	DÈºÁ´Çò¾ú	S.Group D	
eae	Enterobacter aerogenes	²úÆø³¦¸Ë¾ú	E.aerogenes	
eag	Pantoea agglomerans	³ÉÍÅ·º¾ú 	P.agglomerans	
eam	Enterobacter amnigenus	ºÓÉú³¦¸Ë¾ú	E.amnigenus	
eav	Enterococcus avium	Äñ³¦Çò¾ú	E.avium	
eca	Enterococcus casseliflavus	Ç¦»Æ³¦Çò¾ú	CatNeg	³¦Çò¾úÊô
ecg	Enterobacter cancerogenus (taylorae)	Éú°©³¦¸Ë¾ú		
ecl	Enterobacter cloacae	Òõ¹µ³¦¸Ë¾ú	E.cloacae	
eco	Escherichia coli	´ó³¦°£Ï£¾ú	E.coli	
edu	Enterococcus durans	ÄÍ¾Ã³¦Çò¾ú	CatNeg	³¦Çò¾úÊô
efa	Enterococcus faecalis	·à³¦Çò¾ú	E.faecalis	
efm	Enterococcus faecium	Êº³¦Çò¾ú	E.faecium	
ega	Enterococcus gallinarum	ğÈ¼¦³¦Çò¾ú 	E.gallinarum	
ele	Eubacterium lentum	³Ù»ºÕæ¸Ë¾ú		
era	Enterococcus raffinosus	ÃŞ×ÓÌÇ³¦Çò¾ú	CatNeg	³¦Çò¾úÊô
erh	Erysipelothrix rhusiopathiae	ºì°ßµ¤¶¾Ë¿¾ú	E.rhusiopathiae	
esa	Enterobacter sakazakii	ÚæÆé³¦¸Ë¾ú	E.sakazakii	
eta	Edwardsiella tarda	³Ù¶Û°®µÂ»ª¾ú	E.tarda	
fgl		Õ³½ğ»Æ¸Ë¾ú		
fin	Chryseobacterium indologenes	²úßÅßá½ğ»Æ¸Ë¾ú	C.indologenes	
fme	Elizabethkingia meningosepticum	ÄÔÄ¤Ñ×°ÜÑªÒÁÀöÉ¯°×¸Ë¾ú	E.meningosepticum	
fne	Fusobacterium necrophorum ss. necrophorum	»µËÀËó¸Ë¾ú		
fnu	Fusobacterium nucleatum ss. Nucleatum	¾ßºËËó¸Ë¾ú		
fod	Myroides odoratum	ÏãÎ¶¾úÊô	M.odoratum	
fu-	Fusobacterium sp.	Ëó¾úÊô		
fus	Fusarium sp.	Á­µ¶¾úÊô	Fusarium sp.	
geo	Geotrichum sp.	µØË¿¾úÊô	Geotrichum sp.	
gmo	Gemella morbillorum	ÂéÕîÂÏÉúÇò¾ú		
gva	Gardnerella vaginalis	ÒõµÀ¼ÓµÂÄÉ¾ú		
hin	Haemophilus influenzae	Á÷¸ĞÊÈÑª¸Ë¾ú	H.influenzae	
hpi	Haemophilus parainfluenzae	¸±Á÷¸ĞÊÈÑª¸Ë¾ú	H.parainfluenzae	
hpy	Helicobacter pylori	ÓÄÃÅÂİ¸Ë¾ú	H.pylori	
kkr	Kocuria kristinae	¿ËÊÏ¿â¿Ë¾ú		
kor	Raoultella ornitholytica	½âÄñ°±ËáÀ­ÎÚ¶û¾ú		
kox	Klebsiella oxytoca	²úËá¿ËÀ×²®¾ú	K.oxytoca	
koz	Klebsiella pneumoniae ss. ozaenae	·ÎÑ×¿ËÀ×²®¾ú³ô±ÇÑÇÖÖ	K.pneumoniae ss.ozaenae	
kpl	Raoultella planticola	Ö²ÉúÀ­ÎÚ¶û¾ú	R.planticola	
kpn	Klebsiella pneumoniae ss. pneumoniae	·ÎÑ×¿ËÀ×²®¾ú	K.pneumoniae	
kva	Kocuria varians	±äÒì¿â¿Ë¾ú		
lad	Leclercia adecarboxylata	·ÇÍÑôÈÀÕ¾ú	L.adecarboxylata	
lap	Lactobacillus acidophilus	ÊÈËáÈéËá¸Ë¾ú		
lmo	Listeria monocytogenes	²úµ¥ºËÀîË¹ÌØ¾ú	L.monocytogenes	
mab	Mycobacterium chelonae ss. abscessus			
met	Methanobacterium sp.	¼×ÍéÏ¸¾úÊô	Methanobacterium sp.	
mic	Micrococcus sp.	Î¢Çò¾úÊô	Micrococcus sp.	
mlu	Micrococcus luteus	ÌÙ»ÆÎ¢Çò¾ú	M.luteus	
mmo	Morganella morganii ss. morganii	Ä¦ÊÏÄ¦¸ù¾ú	M.morganii	
mmu	Mobiluncus mulieris	ĞßÇÓ¶¯Íä¸Ë¾ú	M.mulieris	
mos	Moraxella osloensis	°ÂË¹Â½ÄªÀ­¾ú		
nfa		Æ¤¾ÒÅ«¿¨¾ú		
ngo	Neisseria gonorrhoeae	ÁÜ²¡ÄÎÉª¾ú		
nme	Neisseria meningitidis	ÄÔÄ¤Ñ×ÄÎÉª¾ú		
nor	Normal flora	Õı³£¾úÈº		
nsi	Neisseria sicca	¸ÉÔïÄÎÉªÇò¾ú		
oan	Ochrobactrum anthropi	ÈË²Ô°×¸Ë¾ú	O.anthropi	
pae	Pseudomonas aeruginosa	Í­ÂÌ¼Ùµ¥°û¾ú	P.aeruginosa	
pam	Pasteurella multocida	¶àÉ±°ÍË¹µÂ¾ú	Pasteurella multocida	
pan	Pantoea sp.	·º¾úÊô		
pce	Burkholderia cepacia	Ñó´Ğ²®¿Ë»ô¶ûµÂ¾ú	B.cepacia	
pen		ÇàÃ¹Êô		
pes	Peptostreptococcus anaerobius	ÑáÑõÏû»¯Á´Çò¾ú		
pfl	Pseudomonas fluorescens	Ó«¹â¼Ùµ¥°û¾ú	P.fluorescens	
pgr	Propionibacterium granulosum	¿ÅÁ£±ûËá¸Ë¾ú		
pma	Stenotrophomonas maltophilia	ÊÈÂóÑ¿Õ­Ê³µ¥°û¾ú	S.maltophilia	
pme		ÃÅ¶àÈø¼Ùµ¥°û¾ú		
pmg	Finegoldia magna	´ó·Ò¸ê¶ûµÂ¾ú		
pmi	Proteus mirabilis	ÆæÒì±äĞÎ¸Ë¾ú	P.mirabilis	
ppe	Proteus penneri	ÅíÊÏ±äĞÎ¸Ë¾ú	P.penneri	
ppi	Ralstonia pickettii	Æ¤ÊÏÂŞ¶ûË¹¶Ù¾ú	R.pickettii	
pps	Staphylococcus saccharolyticus	½âÌÇÆÏÌÑÇò¾ú		
ppu	Pseudomonas putida	¶ñ³ô¼Ùµ¥°û¾ú	P.putida	
pr-	Proteus sp.	±äĞÎ¾úÊô	Proteus sp.	
pre	Proteus rettgeri	À×ÊÏ±äĞÎ¸Ë¾ú	P.rettgeri	
pro	Propionibacterium acnes	ğî´¯±ûËá¸Ë¾ú		
prt	Prevotella sp.	ÆÕÀ×ÎÖ¾úÊô		
pst	Providencia stuartii	Ë¹ÊÏÆÕÂŞÍşµÇË¹¾ú	P.stuartii	
pvu	Proteus vulgaris	ÆÕÍ¨±äĞÎ¸Ë¾ú		
pwi	Prototheca wickerhamii	ÎºÊÏÔ­±Ú¾ú	P.wickerhamii	
ral		ÂŞ¶ûË¹¶Ù¾ú		
rhi		¸ùÃ¹Êô		
sab	Salmonella Paratyphi B	ÒÒĞÍ¸±ÉËº®É³ÃÅ¾ú		
sai	Staphylococcus auricularis	¶úÆÏÌÑÇò¾ú	S.auricularis	
saj	Abiotrophia adiacens	Æ¶Ñõ¿ÅÁ£Á´¾ú	A.adiacens	
sal	Salmonella sp.	É³ÃÅ¾úÊô		
sam	Salmonella Typhimurium	ÊóÉËº®É³ÃÅ¾ú		
san	Streptococcus anginosus	ÑÊÏ¿Ñ×Á´Çò¾ú	S.anginosus	
sap	Staphylococcus saprophyticus	¸¯ÉúÆÏÌÑÇò¾ú	S.saprophyticus	
sas	Scedosporium apiospermum	¼â¶ËÈü¶àæß×Ó¾ú	Scedosporium apiospermum	
sau	Staphylococcus aureus ss. Aureus	½ğ»ÆÉ«ÆÏÌÑÇò¾ú	S.aureus	
sca	Staphylococcus capitis ss. capitis	Í·×´ÆÏÌÑÇò¾ú	S.capitis	
sce		Äğ¾Æ½ÍÄ¸¾ú		
scg	Staphylococcus chromogenes	²úÉ«ÆÏÌÑÇò¾ú		
scn	"Staphylococcus, coagulase negative"	Äı¹ÌÃ¸ÒõĞÔÆÏÌÑÇò¾ú	S.coagulase negative	
scp	Staphylococcus caprae	É½ÑòÆÏÌÑÇò¾ú		
sct		ĞÇ×ùÁ´Çò¾úĞÇ×ùÑÇÖÖ		
sdf	Abiotrophia defectiva	È±Ïİ·¦Ñø¾ú		
sdy	Streptococcus dysgalactiae ss. Dysgalactiae	Í£ÈéÁ´Çò¾ú		
sep	Staphylococcus epidermidis	±íÆ¤ÆÏÌÑÇò¾ú	S.epidermidis	
sfo	Serratia fonticola	¾ÓÈªÉ³À×¾ú		
sgc	Streptococcus agalactiae	ÎŞÈéÁ´Çò¾ú	S.agalactiae	
sgl	Staphylococcus gallinarum	¼¦ÆÏÌÑÇò¾ú		
sgo	Streptococcus gordonii	¸ñÊÏÁ´Çò¾ú	S.gordonii	
sgu	Streptococcus parasanguinis	¸±ÈÜÑªÁ´Çò¾ú		
sgy	Streptococcus gallolyticus	½âÃ»Ê³×ÓËáÁ´Çò¾ú	S.gallolyticuss	
shb	Shigella flexneri	¸£ÊÏÖ¾ºØ¾ú		
shl	Staphylococcus haemolyticus	ÈÜÑªÆÏÌÑÇò¾ú	S.haemolyticus	
sho	Staphylococcus hominis ss. hominis	ÈËÆÏÌÑÇò¾ú	S.hominis	
sin	Streptococcus intermedius	ÖĞ¼äÁ´Çò¾ú	S.intermedius	
sle	sciuriÆÏÌÑÇò¾ú	ÆÏÌÑÇò¾ú		
slq	Serratia liquefaciens	¾ÓÈªÉ³À×¾ú	S.liquefaciens	
slu	Staphylococcus lugdunensis	Â·µËÆÏÌÑÇò¾ú	S.lugdunensis	
sly	Streptococcus alactolyticus	·Ç½âÈéÌÇÁ´Çò¾ú	S.alactolyticus	
sma	Serratia marcescens	Õ³ÖÊÉ³À×¾ú	S.marcescens	
sml	Sphingobacterium multivorum	¶àÊ³ÇÊ°±´¼¸Ë¾ú	S.multivorum	
smt	Streptococcus mitis	»ºÖ¢Á´Çò¾ú	S.mitis	
sol	Streptococcus oralis	¿ÚÇ»Á´Çò¾ú		
spa	Sphingomonas paucimobilis	ÉÙ¶¯ÇÊ°±´¼µ¥°û¾ú	S.paucimobilis	
spf	Shewanella putrefaciens	¸¯°ÜÏ£Íß¾ú	S.putrefaciens	
spn	Streptococcus pneumoniae	·ÎÑ×Á´Çò¾ú	S.pneumoniae	
spp	Streptococcus pleomorphus	¶àĞÎÁ´Çò¾ú		
ssa	Streptococcus salivarius	ÍÙÒºÁ´Çò¾ú	S.salivarius	
ssi	Staphylococcus simulans	Ä£·ÂÆÏÌÑÇò¾ú	S.simulans	
ssn	Streptococcus sanguinis	ÑªºìÁ´Çò¾ú 	S.sanguinis	
ssr	Staphylococcus sciuri ss. sciuri	ËÉÊóÆÏÌÑÇò¾ú		
stc		¿ÆÊÏÆÏÌÑÇò¾ú¿ÆÊÏÑÇÖÖ		
str	Streptococcus sp.	Á´Çò¾úÊô		
sul	Staphylococcus cohnii ss. urealyticum	¿ÆÊÏÆÏÌÑÇò¾ú½âëåÑÇÖÖ	S.cohnii ss. urealyticum	
svi	"Streptococcus viridans, alpha-hem."	²İÂÌÉ«Á´Çò¾ú	"S.viridans, alpha-hem."	
swa	Staphylococcus warneri	ÎÖÊÏÆÏÌÑÇò¾ú	S.warneri	
sxy	Staphylococcus xylosus	Ä¾ÌÇÆÏÌÑÇò¾ú	S.xylosus	
tas	Trichosporon asahii	°¢ÈøÏ£Ã«æß×Ó¾ú	T.asahii	
tca	Candida famata	ÎŞÃû¼ÙË¿½ÍÄ¸	C.famata	
tca	Candida famata	ÎŞÃû¼ÙË¿½ÍÄ¸¾ú		
uur	Ureaplasma urealyticum	½âëåÖ§Ô­Ìå	U.urealyticum	
xab	No anaerobes found	Î´Éú³¤ÑáÑõ¾ú		
xcd	No C. difficile found	Î´Éú³¤ÄÑ±æËó¾ú		
xep	No enteric pathogens found	Î´Éú³¤É³ÃÅÖ¾ºØ¾ú		
xfu	No fungi found	Î´Éú³¤Õæ¾ú		
xhp		Î´Éú³¤ÓÄÃÅÂİ¸Ë¾ú		
xmp		Î´Éú³¤Ö§Ô­Ìå		
xmy	No mycobacteria found	Î´Éú³¤·ÖÖ¦¸Ë¾ú		
xxx	No growth	Î´Éú³¤Ï¸¾ú		
yea		½ÍÄ¸¾ú		
